{
    "TileSize" : 16,
    "TileCount" : {
        "x" : 9,
        "y" : 6
    },
    "TilePositions": {
        "DUS" : [1, 1],
        "DU1" : [1, 2],
        "DU2" : [1, 4],
        "DUE" : [1, 3],
        "DMS" : [2, 1],
        "DM1" : [2, 2],
        "DM2" : [2, 4],
        "DME" : [2, 3],
        "DLS" : [3, 1],
        "DL1" : [3, 2],
        "DL2" : [3, 4],
        "WKS" : [2, 7],
        "WK1" : [2, 8],
        "WK2" : [2, 9],
        "WK3" : [3, 7],
        "WK4" : [3, 8],
        "WKE" : [3, 9],
        "FES" : [4, 6],
        "FE1" : [4, 7],
        "FE2" : [4, 8],
        "FEE" : [4, 9],
        "BRS" : [5, 6],
        "BR1" : [5, 7],
        "BR2" : [5, 8],
        "BRE" : [5, 9],
        "BSS" : [6, 6],
        "BS1" : [6, 7],
        "BSE" : [6, 8],
        "SPK" : [6, 9]
    }
}